{
(0, 0):[
"....#............#......................",
"...###.............#####................",
"..#####............#####................",
".#######.########.......................",
".#######.########.....###...............",
"......##..............###.....####......",
"......##......##.........#....####......",
"......####....##.........###.......#....",
"..##..####...............###............",
"#.##....##.....................######.##",
"##.................#####################",
"########################################",
"########################################",
"########################################",
"########################################"
],
}
